8 8
########
#      #
#      #
#      #
#      #
#      #
#   *  #
########
