10 10
##########
#        #
#    #####
#    #   #
#    #   #
#    #   #
#   ##   #
#*       #
#        #
##########
